11111111111111111111111111
1P01C1K00C0010100C00000K01
11C00100E00111K0011C010001
10010C0111C00C01000C011111
1K011001101101111K00011111
1C001C00001100100001110001
1010K0000C0C0C00001C01K001
10000CK01110000K000000C001
1K100111100000100010011011
11111111111111111111111111