1111111111111111
1K01110K101010C1
1C00P1C001111001
100K000EC0000011
1111111111111111