1111111111111
1K01110K10101
1C00P1C001111
100K000EC0011
1111111111111