11111111111111111111111111
1P01C1C00C0010100C00000C01
11C00100E00111C0011C010001
10010C0111C00C01000C011111
1C011001101101111C00011111
1C001C00001100100001110001
1010C0000C0C0C00001C01C001
10000CC01110000K000000C001
1C100111100000100010011011
11111111111111111111111111