1111111111111111
1C01110C101010C1
1C00P1C001111001
100C000EC0000011
1111111111111111