1111111111111
1C01110C10101
1C00P1C001111
100C000EC0011
1111111111111